XXXXXXXXXXXXXXXXXXXXXXX
X@.@...@........@....XX
X@.@...@.............XX
X@@..................XX
X......@.........@...XX
X....................XX
X............@.......XX
X...@....@...........XX
X...............@....XX
X........@...........XX
X..@.................XX
XXXXXXXXXXXXXXXXXXXXXXX
XXXXXXXXXXXXXXXXXXXXXXX
